1...............
1...............
1...............
1...........2.5.
1111111.........
......1.....3.6.
......1.........
......1.....4.7.
......1.........
......1.........
......111111....
...........1....
