1...............
1...............
1...............
11..........2.5.
.1..............
.1..........3.6.
.1..............
.1..........4.7.
.1111111........
.......1........
.......1111.....
..........1.....
