1...............
1...............
1...............
1...........2.5.
1...............
1...........3.6.
1...............
1...........4.7.
1...............
111111111111....
...........1....
...........1....
